3 3 3 3 3 3 3 3 3 3 3 3 3 3 3 3 3 3 3 3 3 3 3 3 3 3 3 3
3 1 1 1 1 1 1 1 1 1 1 1 1 1 1 1 1 1 1 1 1 1 1 1 1 1 1 3
3 1 3 3 3 1 3 3 3 1 3 3 3 3 1 3 3 3 1 3 3 3 1 3 3 3 1 3
3 1 3 3 3 1 3 3 3 1 3 3 3 3 1 3 3 3 1 3 3 3 1 3 3 3 1 3
3 1 3 3 3 1 3 3 3 1 3 3 3 3 1 3 3 3 1 3 3 3 1 3 3 3 1 3
3 1 1 2 1 1 2 1 1 1 1 1 1 1 1 1 2 1 1 1 1 1 1 1 1 1 1 3
3 1 3 3 3 1 3 3 3 1 3 3 3 3 1 3 3 3 1 3 3 3 1 3 3 3 1 3
3 1 3 3 3 1 3 3 3 1 3 3 3 3 1 3 3 3 1 3 3 3 1 3 3 3 1 3
3 1 3 3 3 1 3 3 3 1 3 3 3 3 1 3 3 3 1 3 3 3 1 3 3 3 1 3
3 2 1 1 1 2 1 1 1 1 1 1 1 1 1 1 1 1 1 1 1 1 1 1 1 1 1 3
3 1 3 3 3 1 3 3 3 1 3 3 3 3 1 3 3 3 1 3 3 3 1 3 3 3 1 3
3 1 3 3 3 1 3 3 3 1 3 3 3 3 1 3 3 3 1 3 3 3 1 3 3 3 1 3
3 1 3 3 3 1 3 3 3 1 3 3 3 3 1 3 3 3 1 3 3 3 1 3 3 3 1 3
7 1 1 1 1 1 1 1 1 1 1 1 1 1 1 1 1 1 1 1 1 1 1 1 1 1 1 7
3 1 3 3 3 1 3 3 3 1 3 3 3 3 1 3 3 3 1 3 3 3 1 3 3 3 1 3
3 1 3 3 3 1 3 3 3 1 3 3 3 3 1 3 3 3 1 3 3 3 1 3 3 3 1 3
3 1 3 3 3 1 3 3 3 1 3 3 3 3 1 3 3 3 1 3 3 3 1 3 3 3 1 3
3 1 1 1 1 1 1 1 1 1 1 1 1 1 1 1 1 1 1 1 1 1 1 1 1 1 1 3
3 1 3 3 3 1 3 3 3 1 3 3 3 3 1 3 3 3 1 3 3 3 1 3 3 3 1 3
3 1 3 3 3 1 3 3 3 1 3 3 3 3 1 3 3 3 1 3 3 3 1 3 3 3 1 3
3 1 3 3 3 1 3 3 3 1 3 3 3 3 1 3 3 3 1 3 3 3 1 3 3 3 1 3
3 1 1 1 1 1 1 1 1 9 1 1 1 1 1 1 1 1 1 9 1 1 1 1 1 1 1 3
3 1 3 3 3 1 3 3 3 1 3 3 3 3 1 3 3 3 1 3 3 3 1 3 3 3 1 3
3 1 3 3 3 1 3 3 3 1 3 3 3 3 1 3 3 3 1 3 3 3 1 3 3 3 1 3
3 1 3 3 3 1 3 3 3 1 3 3 3 3 1 3 3 3 1 3 3 3 1 3 3 3 1 3
3 1 1 1 1 1 1 1 1 9 1 1 1 1 1 1 1 9 1 1 1 2 1 1 1 1 1 3
3 1 3 3 3 1 3 3 3 1 3 3 3 3 1 3 3 3 1 3 3 3 1 3 3 3 1 3
3 1 3 3 3 1 3 3 3 1 3 3 3 3 1 3 3 3 1 3 3 3 1 3 3 3 1 3
3 1 3 3 3 1 3 3 3 1 3 3 3 3 1 3 3 3 1 3 3 3 1 3 3 3 1 3
3 1 1 1 1 1 1 1 1 1 1 1 1 1 1 1 1 1 1 1 1 1 1 1 1 1 1 3
3 3 3 3 3 3 3 3 3 3 3 3 3 3 3 3 3 3 3 3 3 3 3 3 3 3 3 3